2 13 31
###############################
#p * *3       *  ** * *      *#
# # # # #*# # #f# # # # # #*# #
#    * * s** **      *    **  #
# #*# # # # #1# #b#4# # # # #*#
#   7     x*     **      *  **#
# # #*# # # # # #*#*#*#*# # # #
#   *   5    *   s * * *      #
# # # # #*# # # # # # #*# #*# #
#   *b**   6    *1       b    #
# # # # # # # # # #*# # # # #*#
#  ** *   *    2      s       #
###############################