5 13 31
###############################
#p * *3       f  ** * *      *#
# # # # #*# # #*# # # # # #*# #
#    * * *** **  5   *    **  #
# #*# # # # #4# #b#1# # # # #*#
#          s     **      *  **#
# # #b# # # # # #*#*#*#*# # # #
#   *        *   * *x* *   4  #
# # # # #*# # # # # # #*# #*# #
#   ****         *6           #
# # # # # # # # # #*# # # # #*#
#  ** *7  *    6              #
###############################