4 13 31
###############################
#p    * **    *   3   4       #
# # # #*# # # # # # # # # # # #
#      s* * *  *   * ** 3 *   #
# # # # # #*# # # # # # #*# # #
#*   * *    *b* *   **        #
# # # # # # # # # # # # # #*# #
#    f     *        *    **  3#
# #*# # #*#*#*#*# # #1# # #*# #
#        * 4 *3*    *   *     #
#*# # # # # # # # # # #*# # #*#
#x*    * **    ** ***     5   #
###############################