3 13 31
###############################
#p   ** b*    *   2           #
# # # #*# # # # # # # # # # # #
#*     ** * *  *   * ** 3 *   #
# # # # # #*# # # # # # #*# # #
#*   *s*    *** *   **        #
# # # # # # # # # # # # # #*# #
#    f     *   1    b    **  3#
# #*# # #*#*#*#*# # #1# # #*# #
#        *   *2*    *   *     #
#*# # # # # # # # # # #*# # #*#
# *    * **    ** *s*        q#
###############################