2 13 31
###############################
#p * *2       *  ** * *      *#
# # # # #*# # #f# # # # # #*# #
#    * * s** **      *    **  #
# #*# # # # #1# #b#1# # # # #*#
#          *     **      *  **#
# # #*# # # # # #*#*#*#*# # # #
#   *        *   s * * *      #
# # # # #*# # # # # # #*# #*# #
#   *b**        *1       b    #
# # # # # # # # # #*# # # # #*#
#  ** *   *    2      s      q#
###############################